#######Aa######
#      =      #
# #####=##### #
###   #=#   ###
   ####=####
   #   =   #
d###   =   ####
D======$======B
# ###  =  ### b
# # #  =  # # #
# # #  =  # # #
# # #  =  # # #
# # #  =  # # #
# # #  =  # # # 
# # # cC# # # #
# # # # # # # #
# # # # # # # #
# # # # # # # #
# # # # # # # #
# # # # # # # #
# # # # # # # #
### ### ### ###